11111111111111111111111111111111111111111
1P0000E0000000000000000000000000000000001
10000000000000000000000000000000000000001
10000000000000000000000000C00000000000001
10101010101010101010101010000000001111111
10000000000000000000001011111111111111111
10000000000000000000001011111111111111111
10000010000000000000001011111111111111111
10000000000000000000001011111111111111111
10000000000000000000001011111111111111111
10000000000000000000001011111111111111111
10000000000000000000001011111111111111111
10000000000000000000001E11111111111111111
11111111111111111111111111111111111111111
